OOOXXOOOOXOOOOO
XOOXOOOXOOOXOXO
XOOOOXOXXXXXXXX
XXXXXXOOOOOOOOO
OOOOOOOOOOOXXOO
OOXOOXXXXXXXXOO
XOXOOXOOOOOOOOO
XOXOOXOXXXXXOOO
OOXOOOOXOOOXOOO
XXXXOOOOOOOXXXX
XOOOOOOOXXXOXOX
XOXXXOXOXOXOOOX
XOXOXOXOXOOOOXX
XOOOXOOOXOXOOOO
OOXOOOXOOOXOXOO