XXXXXXOOOXOOOOO
dOXXOOOXOOOXOXO
XOOOOXOXXOXXXXX
XXXXXXOXOOOOOOX
OOOOOOOOOXOXXOX
OOXOOXXXXXXXXOX
XOXOOXOOOOOOOOO
XOXOOXOXXXXXOXO
OOXOOOOXOOOXOXO
XXXXXXOOOOOXXXX
XOOOOOOOXXXXXOX
XOXXXOXOXOXOOOX
XOXOXOXXXOOOOXX
XOOOXOOOXOXOOOX
OOXOOOXOOOXOXOa
